NO ./textures/wall_n.xpm
SO ./textures/wall_s.xpm
WE ./textures/wall_w.xpm
EA ./textures/wall_e.xpm

F 220,100,0
C 225,30,0

      
1111111111
1000000001
1000000001
1000000001
10000000E1
1111111111
