NO ./textures/wall_n.xpm
SO ./textures/wall_s.xpm
WE ./textures/wall_w.xpm
EA ./textures/wall_e.xpm

F 220,100,0
C 225,30,0

1101111111111111
1000000001 10001
1000000001 10011
1000000001 101
10000000W1 111
1111111111      1
